rubric_id,assignmentid,Textual Evidence and Analysis,Theme and Central Idea Development,Character and Event Analysis,Vocabulary and Language Use,Writing Quality and Cohesion,Total Score
1,AID_1,25,20,20,15,20,100
1,AID_2,24,19,19,13,19,94
1,AID_3,23,18,18,12,17,88
1,AID_4,15,12,12,10,12,61
1,AID_5,25,20,20,14,20,99
1,AID_6,24,19,19,13,19,94
1,AID_7,23,18,18,12,17,88
1,AID_8,12,10,10,9,10,51
1,AID_9,24,19,20,14,19,96
1,AID_10,23,18,19,13,17,90